30000500
01111110
01114110
21110110
01110112
01110010
01111000
00051115