11111111
10002001
10210021
10141101
10502001
10011151
10050031
11111111