111111500053
200055000110
111110050111
555000000002
111111110111
000550200000
111111111001
000111500550
111000001100
222000055011
500050005000
222411110000