1100000511
1101511011
1121000021
1100011501
1101130000
1101411110
1101011110
1121011000
0000000011
1121251111