1111111111
1222222221
1000000001
1011111001
1011111551
1014131551
1010151551
1000155551
1000155551
1111111111