310151012111
000000000011
510110110111
120010510001
110011111101
111011111101
111011111101
100000000100
121010110210
105010000100
101011011101
151211000421