001110000050
000501001111
002000000000
010001000500
010101000111
010101300001
010501000051
010001000000
012000111110
011100102000
000100101111
000020000004