202020202020
020202020202
000000000000
000000000000
000000000000
000000400000
000000000000
000000000000
000000000000
000000000000
000000000000
555555555553