1111111111
1300000051
1111111101
1100000101
1101110121
1101410101
1101002101
1101111101
1150000001
1111111111