11111111
13000001
10105101
10102111
10510001
10011051
11020041
11111111